AFFINITY-R|AFFINITY-R|RETAILER|FULL|OPTIN|WS|OPTIN||VWA|VSA|TWA|TSA||Affinity Water Limited 
AFFINITY-W|AFFINITY-W|WHOLESALER|FULL|OPTIN|WS|OPTIN||VWA|VSA|TWA|TSA||Affinity Water Limited 
ALBION-W|ALBION-W|WHOLESALER|FULL|OPTIN|WS|OPTIN||VWA|VSA|TWA|TSA||Albion Water Limited
ALBION-R|ALBION-R|RETAILER|FULL|OPTIN|WS|OPTIN||VWA|VSA|TWA|TSA||Albion Water Limited
ANGLIAN-W|ANGLIAN-W|WHOLESALER|FULL|OPTIN|WS|OPTIN||VWA|VSA|TWA|TSA||Anglian Water Services Limited
ANGLIAN-R|ANGLIAN-R|RETAILER|FULL|OPTIN|WS|OPTIN||VWA|VSA|TWA|TSA||Anglian Water Services Limited
ONDEO-R|ONDEO-R|RETAILER|FULL|OPTIN|WS|OPTIN||VWA|VSA|TWA|TSA||Ondeo Industrial Solutions Limited
NORTHUM-W|NORTHUM-W|WHOLESALER|FULL|OPTIN|WS|OPTIN||VWA|VSA|TWA|TSA||Northumbrian Water Limited
NORTHUM-R|NORTHUM-R|RETAILER|FULL|OPTIN|WS|OPTIN||VWA|VSA|TWA|TSA||Northumbrian Water Limited
PEEL-W|PEEL-W|WHOLESALER|FULL|OPTIN|WS|OPTIN||VWA|VSA|TWA|TSA||Peel Water Networks Limited
PEEL-R|PEEL-R|RETAILER|FULL|OPTIN|WS|OPTIN||VWA|VSA|TWA|TSA||Peel Water Networks Limited
SCOTTISH-W|SCOTTISH-W|WHOLESALER|FULL|OPTIN|WS|OPTIN||VWA|VSA|TWA|TSA||Scottish Water - W / Business Stream Limited
BUSSTREAM-R|BUSSTREAM-R|RETAILER|FULL|OPTIN|WS|OPTIN||VWA|VSA|TWA|TSA||Scottish Water - R / Business Stream Limited 
UNITED-W|UNITED-W|WHOLESALER|FULL|OPTIN|WS|OPTIN||VWA|VSA|TWA|TSA||United Utilities Water Limited
UNITED-R|UNITED-R|RETAILER|FULL|OPTIN|WS|OPTIN||VWA|VSA|TWA|TSA||United Utilities Water Limited
YORKSHIRE-W|YORKSHIRE-W|WHOLESALER|FULL|OPTIN|WS|OPTIN||VWA|VSA|TWA|TSA||Yorkshire Water Services Limited
YORKSHIRE-R|YORKSHIRE-R|RETAILER|FULL|OPTIN|WS|OPTIN||VWA|VSA|TWA|TSA||Yorkshire Water Services Limited
COBALT-R|COBALT-R|RETAILER|FULL|OPTIN|WS|OPTIN||VWA|VSA|TWA|TSA||Cobalt Water Limited
CASTLE-R|CASTLE-R|RETAILER|FULL|OPTIN|WS|OPTIN||VWA|VSA|TWA|TSA||Castle Water Limited
SOUTHEAST-W|SOUTHEAST-W|WHOLESALER|FULL|OPTIN|WS|OPTIN||VWA|VSA|TWA|TSA||South East Water Limited
SOUTHEAST-R|SOUTHEAST-R|RETAILER|FULL|OPTIN|WS|OPTIN||VWA|VSA|TWA|TSA||South East Water Limited
SOUTHERN-W|SOUTHERN-W|WHOLESALER|FULL|OPTIN|WS|OPTIN||VWA|VSA|TWA|TSA||Southern Water Services Limited
SOUTHERN-R|SOUTHERN-R|RETAILER|FULL|OPTIN|WS|OPTIN||VWA|VSA|TWA|TSA||Southern Water Services Limited
SUTTON-W|SUTTON-W|WHOLESALER|FULL|OPTIN|WS|OPTIN||VWA|VSA|TWA|TSA||Sutton and East Surrey Water Plc
SUTTON-R|SUTTON-R|RETAILER|FULL|OPTIN|WS|OPTIN||VWA|VSA|TWA|TSA||Sutton and East Surrey Water Plc
THAMES-W|THAMES-W|WHOLESALER|FULL|OPTIN|WS|OPTIN||VWA|VSA|TWA|TSA||Thames Water Limited
THAMES-R|THAMES-R|RETAILER|FULL|OPTIN|WS|OPTIN||VWA|VSA|TWA|TSA||Thames Water Limited
BLUEBUS-R|BLUEBUS-R|RETAILER|FULL|OPTIN|WS|OPTIN||VWA|VSA|TWA|TSA||Blue Business Water Limited
BOURNEMTH-W|BOURNEMTH-W|WHOLESALER|FULL|OPTIN|WS|OPTIN||VWA|VSA|TWA|TSA||Bournemouth Water Limited
BOURNEMTH-R|BOURNEMTH-R|RETAILER|FULL|OPTIN|WS|OPTIN||VWA|VSA|TWA|TSA||Bournemouth Water Limited
BRISTOL-W|BRISTOL-W|WHOLESALER|FULL|OPTIN|WS|OPTIN||VWA|VSA|TWA|TSA||Bristol Water Plc
BRISTOL-R|BRISTOL-R|RETAILER|FULL|OPTIN|WS|OPTIN||VWA|VSA|TWA|TSA||Bristol Water Plc
PORTSMOUTH-W|PORTSMOUTH-W|WHOLESALER|FULL|OPTIN|WS|OPTIN||VWA|VSA|TWA|TSA||Portsmouth Water Limited
PORTSMOUTH-R|PORTSMOUTH-R|RETAILER|FULL|OPTIN|WS|OPTIN||VWA|VSA|TWA|TSA||Portsmouth Water Limited
SOUTHWEST-W|SOUTHWEST-W|WHOLESALER|FULL|OPTIN|WS|OPTIN||VWA|VSA|TWA|TSA||South West Water Limited
SOUTHWEST-R|SOUTHWEST-R|RETAILER|FULL|OPTIN|WS|OPTIN||VWA|VSA|TWA|TSA||South West Water Limited
VEOLIA-R|VEOLIA-R|RETAILER|FULL|OPTIN|WS|OPTIN||VWA|VSA|TWA|TSA||Veolia Water Projects Limited
WESSEX-W|WESSEX-W|WHOLESALER|FULL|OPTIN|WS|OPTIN||VWA|VSA|TWA|TSA||Wessex Water Services Limited
WESSEX-R|WESSEX-R|RETAILER|FULL|OPTIN|WS|OPTIN||VWA|VSA|TWA|TSA||Wessex Water Services Limited
CLEARBUS-R|CLEARBUS-R|RETAILER|FULL|OPTIN|WS|OPTIN||VWA|VSA|TWA|TSA||Clear Business Water Limited
DWRCYMRU-W|DWRCYMRU-W|WHOLESALER|FULL|OPTIN|WS|OPTIN||VWA|VSA|TWA|TSA||Dwr Cymru Cyfyngedig
DWRCYMRU-R|DWRCYMRU-R|RETAILER|FULL|OPTIN|WS|OPTIN||VWA|VSA|TWA|TSA||Dwr Cymru Cyfyngedig
SEVERN-W|SEVERN-W|WHOLESALER|FULL|OPTIN|WS|OPTIN||VWA|VSA|TWA|TSA||Severn Trent Water Limited
SEVERN-R|SEVERN-R|RETAILER|FULL|OPTIN|WS|OPTIN||VWA|VSA|TWA|TSA||Severn Trent Water Limited
SOUTHSTAFF-W|SOUTHSTAFF-W|WHOLESALER|FULL|OPTIN|WS|OPTIN||VWA|VSA|TWA|TSA||South Staffordshire Water Plc
SOUTHSTAFF-R|SOUTHSTAFF-R|RETAILER|FULL|OPTIN|WS|OPTIN||VWA|VSA|TWA|TSA||South Staffordshire Water Plc
AIMERA-R|AIMERA-R|RETAILER|FULL|OPTIN|WS|OPTIN||VWA|VSA|TWA|TSA||Aimera Limited 
CHOLDERTON-W|CHOLDERTON-W|WHOLESALER|FULL|OPTIN|WS|OPTIN||VWA|VSA|TWA|TSA||Cholderton and District Water Company Limited
CHOLDERTON-R|CHOLDERTON-R|RETAILER|FULL|OPTIN|WS|OPTIN||VWA|VSA|TWA|TSA||Cholderton and District Water Company Limited
COMMERCIAL-R|COMMERCIAL-R|RETAILER|FULL|OPTIN|WS|OPTIN||VWA|VSA|TWA|TSA||Commercial Water Solutions Limited 
DEEVALLEY-W|DEEVALLEY-W|WHOLESALER|FULL|OPTIN|WS|OPTIN||VWA|VSA|TWA|TSA||Dee Valley Water plc 
DEEVALLEY-R|DEEVALLEY-R|RETAILER|FULL|OPTIN|WS|OPTIN||VWA|VSA|TWA|TSA||Dee Valley Water plc 
EVERFLOW-R|EVERFLOW-R|RETAILER|FULL|OPTIN|WS|OPTIN||VWA|VSA|TWA|TSA||Everflow Limited
INDWATER-W|INDWATER-W|WHOLESALER|FULL|OPTIN|WS|OPTIN||VWA|VSA|TWA|TSA||Independent Water Networks Ltd (Cardiff)
INDWATER-R|INDWATER-R|RETAILER|FULL|OPTIN|WS|OPTIN||VWA|VSA|TWA|TSA||Independent Water Networks Ltd (Cardiff)
KELDA-R|KELDA-R|RETAILER|FULL|OPTIN|WS|OPTIN||VWA|VSA|TWA|TSA||Kelda Water Services (Retail) Limited 
REALWATER-R|REALWATER-R|RETAILER|FULL|OPTIN|WS|OPTIN||VWA|VSA|TWA|TSA||Real Water Edinburgh Limited
SOURCE-R|SOURCE-R|RETAILER|FULL|OPTIN|WS|OPTIN||VWA|VSA|TWA|TSA||Source for Business Limited (part of SW Water)
SSE-W|SSE-W|WHOLESALER|FULL|OPTIN|WS|OPTIN||VWA|VSA|TWA|TSA||SSE Water Ltd
SSE-R|SSE-R|RETAILER|FULL|OPTIN|WS|OPTIN||VWA|VSA|TWA|TSA||SSE Water Ltd
WATER2BUS-R|WATER2BUS-R|RETAILER|FULL|OPTIN|WS|OPTIN||VWA|VSA|TWA|TSA||Water 2 Business Ltd 
